input_4,input_3,input_2,input_1,output_1,output_2,output_3,output_4,output_5,output_6,output_7
0,0,0,0,1,1,1,1,1,1,0
0,0,0,1,0,1,1,0,0,0,0
0,0,1,0,1,1,0,1,1,0,1
0,0,1,1,1,1,1,1,0,0,1
0,1,0,0,0,1,1,0,0,1,1
0,1,0,1,1,0,1,1,0,1,1
0,1,1,0,1,0,1,1,1,1,1
0,1,1,1,1,1,1,0,0,0,0
1,0,0,0,1,1,1,1,1,1,1
1,0,0,1,1,1,1,1,0,1,1
1,0,1,0,x,x,x,x,x,x,x
1,0,1,1,x,x,x,x,x,x,x
1,1,0,0,x,x,x,x,x,x,x
1,1,0,1,x,x,x,x,x,x,x
1,1,1,0,x,x,x,x,x,x,x
1,1,1,1,x,x,x,x,x,x,x
