input_3,input_2,input_1,output_1,output_2
0,0,0,0,0
0,0,1,1,0
0,1,0,1,0
0,1,1,0,1
1,0,0,1,0
1,0,1,0,1
1,1,0,0,1
1,1,1,1,1
